clone,build,package,packagetests,symbols,clobber,total
130,3746,35,18,850,159,4938
189,3751,37,17,839,180,5013
193,3806,38,18,820,161,5036
185,3815,35,25,835,163,5058
182,3800,38,18,822,162,5022
190,3899,39,20,851,159,5158
182,3857,39,19,849,164,5110
190,3894,36,21,889,165,5195
199,3853,39,28,839,173,5131
184,3827,36,18,835,174,5074
